_______________________________________________________________________________
  There are about 800 prefixes and word beginnings in the englex package:

  Reference: Prefixes and Other Word-Initial Elements of English
		  by Laurence Urdang (Editorial Director),
	  	  and Alexander Humez (Editor)
			  Copyrighted 1984 by:
			  Gale Research Company
			  Book Tower
			  Detroit, Michigan 48226
             [Reference From The Lockwood Library At The University Of 
	      Buffalo: Catalogue #: Ref PE 1175 P68 In Their Reference Area]

Note: This book states that all occurrences in the book have at least
      5 occurrences or otherwise the prefix or word beginning is very common.


BELOW: Examples are to the right of the prefix or word beginning

Note: 1)The lines where my own examples start are marked by the symbol '*'
        [Reference AHD].

      2)The prefixes: anti, dis, il, im, in, ir, mis, pre, un, re, and semi 
        can be used without suffixes or word endings, simply because that's 
        how the original englex package worked.

_______________________________________________________________________________

a		afresh arise asleep asymmetry avoid abide amoral atheist
ab		* aboral abcoulomb abduct abfarad absolve abfarad
abs		abscess abstain abstract abstraction 
ac   		accumulate accord
acu		acuclosure acupuncture acusection
acuti		acutifoliate acutilingual acutilobate
ad   		adhere address
af   		affiliate affluence
after  		afterbirth afterimage after-care
ag		agglomerate agglutination aggrandize 
		* agape agglutinate aggrade agnail
air   		aircraft airline air-dry
al   		alleviate allow
alter		altercative alteregoism
ali   		aliform alinasal alisphenoid
all   		allheal all-important all-purpose
alti 		altimeter altigraph
am		ambush
		* amice amidol ammeter 
amnio 		amniocentesis amnioplastin amniorrhexis
amphi		amphiblastic amphicentric
		* amphipod amphitheater
an   		anarchy annihilate 
ant		antacid
		* anteater
ante		antenuptial anteposition antefebrile
		* antedate antefix
antero		anterograde anteroposterior antero-internal
anti   		antimatter antiblastic anti-intellectual
		* antiaircraft
any		anybody anyhow anyway
ap		approve apparatus apandria
		* appoint appeal
aqua           	aqualung aquaplane aquacade
ar   		arrest arrange arraign
arch		archangel archdeacon archenemy
		* archdiocese
arm   		armchair armband armhole army
arti		artifact artifex
		* artichoke
as   		assent assimilate 
astro		astrocyte astrophysics
		* astrodynamics astrosphere
at		attempt attend attract
		* atman atone attack attar attest attorn
atmo 		atmograph atmosphere atmocausis
		* atmometer
auto   		autobus autoanalysis autoblood
avi 		aviculture avifauna
		* avifauna
back   		backbone backstroke back-up
bad   		badman badlands bad-mouth
bag   		bagpipe bagman bagworm
bar   		barfly barhop barstool barite
bare   		bareback barefaced
barn   		barnstorm barndoor barnyard
baro		barometer baroagnosis barophilic
		* barograph
base   		basecoat baseline baseboard
basi		basicranial basifacial basilemma
		* basinet basipetal
be 		behead bejewel befoul
beach   	beachcomber beachhead
bean   		beanpole bean-bag beanfeast
bear   		bearcat	bearskin bear leader
bed   		bedbug bedroll bedrock
beef   		beefcake beefsteak beefwood
bell   		bellman bellhop bellwether
belly   	bellyache bellybutton bellyful
bene		benediction benefactor benevolent
		* benefit
big   		bigwig big-head big-name
bili		bilirubin bilitherapy
		* bilinear
bin		binauricular biniodide binophthalmoscope
		* bingo binocular
bio   		biogenesis biomutation bio-assay
		* biotin biotype
bird 		birdbrain birdbath bird-dog
birth   	birthday birthstone birthright 
bitter   	bittersweet bitternut bitterender
black   	blackball blackout blackberry
block   	blockbuster blockhead blockade
blood   	bloodline bloodsucker bloodflower
blow   		blowfish blow-hard blowball
blue   		bluegrass blueberry blue-chip
boat   		boatload boatswain boatbill
body 		bodyguard bodywork bodycheck
bomb   		bombproof bombshell bombload
bone   		bonehead boneyard bonesetter
book   		bookmaker bookworm bookbinder
boot   		bootleg bootyard bootjack boottopping
boro		borosilicate borohydride boroglyceride
bou		boulemia bouphonia boustrophedon
bow   		bowdrill bowknot bowman bowstring bowgrace bowsprit
box   		boxcar boxhead box-spring
brain   	brainwash brainchild brainpan
bread   	breadbasket breadboard breadfruit
break 		breakdown breakthrough breakwater
breast 		breastbone breast-feed breast-hook
breech   	breechblock breechloader breechcloth
bridge   	bridgework bridgeman bridgehead
broad   	broadside broadax broadband
brown   	brownout brown-nose brownie
brush   	brushup brush-off brushwood
bug   		bugseed bug-eyed bugbane
bull   		bulldog bullhead bullbat
bur		burdock burstone burweed
		* burden burgage burlap burrow
butter   	buttermilk butterfly buttercup
by 		bylaw by-line bygone
call		callboy callfire call-board
		* callus
calori		calorimeter calorigenic caloripuncture
camel   	camelback camelbird camelgrass
cameo		cameoglass cameopress cameoware
camera   	cameraman camerashy camera-ready
candle   	candlepin candleberry candlebeam
car   		carload carport carman
carbo		carbocyclic carbohydrate
		* carbolated
card   		cardboard cardsharp card-carrying
cardio		cardiocentesis cardiokinetic cardio-accelerator
		* cardiograph cardiogram cardiorespiratory
care   		carefree caretaker careworn
carto		cartogram cartography cartomancy
case   		casebound caseload casebook caseworker caseharden caseworm
cash   		cashbox cashdrawer cashbook
cast 		castaway cast-off cast-iron
cat   		catcall catnap catfish
cata		catabatic cataphasia
		* catacombs catamount
catch 		catchall catch-cord
centi		centibar centimeter centinormal
		* centigrade centiliter centipoise
centro		centrodorsal centroosteosclerosis centrocecal
		* centrosome centrosphere
cess   		cesspool cesspit cesspipe
chain   	chainsmoke chainbreak chainstitch
chalk   	chalkboard chalk-line chalkstone
chamber   	chambermaid chamber-pot chamberlain
change   	changemaker changeover changeling
cheap   	cheapskate cheap-jack
check 		checkbook checkpoint checkmark
checker   	checkerboard checkerspot checkerwork
cheese   	cheeseburger cheesecloth cheesecake
chemo		chemobiotic chemoreflex chemotherapy
		* chemosphere chemoreception
chicken   	chicken-livered chickenshit chicken-hearted
child   	childcare childbirth childbed
chuck   	chuckhole chuck-farthing chuck-a-luck
church   	churchman churchgoer churchwarden
circum		circumcorneal circumnavigate circumvallate
		* circumflex circumfuse circumlunar circumpolar circumrotate
		  circumscribe circumstance circumvent
cirro		cirrocumulus cirropodous cirrostomous
		* cirrostratus
city   		cityward cityscape city-state
clap 		claptrap clap-stick clap-sill
class   	classmate classbook classical
clavi		clavichord clavicylinder clavipectoral clavicorn claviform
claw   		clawfoot claw-hammer clawhand
clean   	cleanup clean-cut clean-living
cloak   	cloakroom cloak-bag cloak-and-dagger
clock  		clockwise clockwork clockmaker
clod   		clodhopper clodpoll clodpate
close   	closefisted close-fitting close-fertilization
cloth   	clothbound cloth-yard cloth-stitch
clothes 	clothespin clothesline clotheshorse
cloud   	cloudburst cloudland cloud-capped
club   		clubfoot clubhouse clubroot
co   		coactive coworker coconsciousness
coach   	coachman coachwork coach-and-four
coal   		coalbin coalfish coalmouse
coast   	coastline coastguardsman coastward
coat   		coattail coatroom coatdress
cock   		cockpit cocksure cock-and-bull
cod 		codfish codliver codline
coffee   	coffeehouse coffeepot coffeecake
cog		cogwheel cogwood cog-rail
		* cogon
col		colliquation colonitis colalgia colauxe
		* collapse collard collate collateral colleague collie color
cole   		coleslaw coleseed colerape
coli		coliform colicolitis colipyuria
collar   	collarbone collar-cell collar-work
color   	colorbearer colorfast color-blind
com		combine comfort compare
		* combat combust commeasure commode compact commute compass
		  compassion compart compost compound compress comprise
		  compromise
come		comeback come-on comeuppance
		* comedown
common   	commonplace common-law commonweal
		* commonage commonplace commonwealth
con   		confirm condense
concert   	concertmaster concertgoer concertpitch
cook 		cookbook cookout cookstove
coon   		coonskin cooncat coonhound
copper   	coppersmith copperhead copperplate
copy   		copyright copyreader copybook
cor		correlate correspond corrode
		* cordial corset
coral   	coralfish coralroot coralberry 
core   		coremaker core-print coredialysis core-barrel
cork   		corkscrew corkbrain corkboard
corn   		cornbread cornflakes corncrib
corner   	cornerstone corner-cutter corner-plate
cotton 		cottonweed cottonseed cottontail
council   	councilman council-manager council-book
counter   	countercharge countersink counter-insurgency countertop
country   	countryman countryside country-bred
court   	courthouse courtyard court-dance
cover    	coverall cover-up cover-girl
cow   		cowboy cowfish cowcatcher
crab   		crabstone crabeater crabstick crabstock crabwood
crack 		crackdown crack-up crack-off
crank   	crankcase crankshaft crankpin
crazy   	crazywork crazyweed crazy-bone
cream   	creamcups creamware cream-colored
crib   		cribwork crib-strap crib-dam
cross   	crossbones crosscurrent cross-bearer
crow   		crowfoot crowbar crowhop
crown   	crownpiece crownwork crown-of-jewels
cruci		cruciform crucifix cruciferous
		* cruciate
cup   		cupcake cupboard cupbearer 
curb 		curbstone curb-chain curb-roof
curvi		curvicaudate curvifoliate curvilinear
cut   		cutaway cutoff cut-and-cover
cyclo		cyclodialysis cyclograph cyclometer
		* cyclopropane cyclohexane
dairy   	dairymaid dairyman dairy-farm
dark   		darkroom dark-field dark-trace (tube)
dash   		dashboard dashpot dash-wheel
date   		dateline datebook date-mark
day   		daybook daydream daytime
de   		decry deface defame deport denude depart de-emphasize
dead   		deadbeat deadline deadfall
death   	deathbed deathtrap deathblow
deck 		deckhouse deckpipe deckhead
deer   		deerskin deerhound deerstalker
devil   	devilfish devilwood devil-may-care
dew   		dewdrop dewfall dewberry
di   		diacid dihysteria dicalcic divest
die   		dieback die-hard die-away diestock diesinker die-holder
dif   		diffuse diffraction
dino 		dinoflagellate dinothere dinosaur
dis   		disagree dissyllabic disband disdiaclast discolor
dish   		dishcloth dishpan dishwasher
dock   		dockside dockwalloper dockyard
dodeca		dodecahedron dodecapetalous dodecasyllabic
dog 		dogcatcher dogtooth dogbane
dollar   	dollarfish dollarbird dollar-a-year (man)
door   		doorbell doorstop door-to-door
dorso		dorsoanterior dorsolumbar dorsomesial
double   	doublethink double-decker double-barreled
dove   		dovetail dovecote dovewood
down   		downwind downfall downhearted
drag   		draghound dragnet drag-chain
dragon   	dragonfly dragonroot dragonhead
drain   	drainboard drainspout drainfield
draw 		drawbridge drawknife draw-sheet
dream   	dreamland dreamboat dream-world
dress   	dressmaker dress-up dress-spur
drift   	driftwood driftbolt driftfish
drill   	drillstock drill-press drill-master
drive   	driveway drive-in drive-wheel
drop   		dropout dropkick dropwort
drum   		drumstick drumbeat drumfish
dry 		drybrush dry-clean dry-gulch
duck   		duckpin ducktail duckbill
dumb   		dumbstruck dumbbell
dust   		dustcloth dustman dustup
dys 		dysfunction dyspeptic dysanagnosia
e   		especial esquire estate emission enumeration
ear   		earache earshot earflap
earth   	earthwork earthmover earthquake
ec		eccentric ecphylactic ecthyreosis
		* eclair ectype
eco		ecophobia ecosphere 
		* ecotone ecotype
ecto		ectodermal ectoglobular ectonuclear
		* ectoparasite
eel   		eelback eelgrass
ef   		effusion efflorescence
egg   		eggnog eggbeater eggplant
eight 		eightball eightfoil eightscore
elbow   	elbowroom elbow-grease elbow-board
electro		electroacoustics electrocoagulation electrojet
		* electrocardiogram electrograph electromagnet electrometer
		  electrostatic electropositive electrotype
elk   		elkwood elkhound elk-grass
em   		embed emmarble emplastic employ
en   		endear enchant engram enanthesis enable
end   		endnote end-all end-blown
engine   	engineman engine-turning
epi   		epicenter epigastric epiphenomenon
equi   		equidistant equilibrium equiprobabilism
ethno		ethnohistory ethnolinquistics ethnomusicology
etho		ethography ethological ethopoetic
ever   		evergreen everlasting evermore
every 		everyday everywhere everyone
ex   		exact ex-wife exanthem exangia
extra   	extrabold extramarital extracystic
eye   		eyeopener eyestone eyebrow
fall   		fallout fall-gate fallfish
false   	falsework false-bottomed false-hearted
fan   		fantail fanback fanjet
far   		faraway far-fetched far-famed
farm   		farmhouse farmland farmyard
fast   		fastback fast-talk fast-breaking
fat 		fathead fatback fat-soluble
feather   	featherbrain featherstitch featherback
feed   		feedback feedbox feedwater
fiber   	fiberglass fiberboard fiberscope
field   	fieldstrip fieldstone fieldfare
figure   	figurehead figure-stone figure-ground
fin   		finfoot finweed finback
finger   	fingernail fingertip fingerbreadth
fire   		firebox firecracker firebug
fish 		fishhook fisheye fishwife
fist   		fistfight fistnote fistic
flag   		flagship flag-waving flagfish
flash   	flashcube flashlight flashback
flat   		flatfoot flatiron flatbread
flea   		fleabag flea-bitten fleawort
flood   	floodgate floodlight floodwater
floor   	floorman floorwalker floorcloth
fly   		flyaway flypaper flywheel flyblown fly-fish fly-by-night
fog 		foghorn fogbound fogdog
food   		foodstuff food-gathering food-fish
fool   		foolhardy foolstones fool-hen
foot   		foothill footfall footpad
for   		forbear forbid forsake forclose forjudge
fore   		forearm foreman foresee
forth   	forthwith forthcoming forthright
foul		foulbrood foulmouthed foul-up
fox   		foxhole foxhound foxfire
free   		freehand freeborn free-for-all
frog   		frogman frogfish froghopper
fronto		frontogenesis frontomaxillary frontonasal
frost 		frostbite frostweed frost-itch
fungi		fungiform fungitoxic fungicide
gain   		gainsay gainstand gaincome
game   		gamekeeper gamebag gamecock
gang   		gangway gangplank gangland
gar		garbill garfish 
		* garboard garboil garden garland garnet
gas   		gaslight gasholder gasbag
gastro 		gastrocolitis gastrodiaphany gastrotherapy
		* gastrointestinal gastropod gastroscope gastrovascular
gate   		gatekeeper gatefold gate-crasher
gear   		gearshift gearwheel gearbox
gem   		gemstone gem-ring gem-peg
gentle   	gentleman gentle-voiced gentlewoman
genu		genuflect genucubital genuclast
		* genuflection 
geo		geochemistry geodynamics geonavigation
		* geometric
get   		getaway get-up get-together
ghost 		ghostland ghostwriter ghost-word
giga   		gigacycle gigahertz gigameter
glass   	glasshouse glassmaking glassware
globe   	globetrotter globeflower globefish
go   		go-ahead go-cart godown
god   		godsend godfather godchild godmother
gold   		goldbrick goldfinch gold-dust
golden   	goldeneye goldenseal goldenrod
good   		good-for-nothing good-humored good-looking
goof 		goofball goof-off goof-up
goose   	gooseherd goose-step gooseneck
grand   	grandchild grandfather grand-stand grandchild grand-scale
grape   	grapefruit grapevine grapeshot
grass   	grasshopper grass-roots grassland
grave   	gravedigger gravestone graveclothes
green   	greenhouse greengrocer greenback
ground   	groundbreaking groundkeeper groundsill
guard 		guardrail guardhouse guardroom
guide   	guideline guidebook guidepost
gum   		gumdrop gumshoe gumwood
gyro		gyrocompass gyroplane gyrospasm
		* gyromagnetic gyroscope
hair   		hairball hair-trigger hair-raising
hand   		handball handkerchief hand-me-down
hang   		hangman hangout hangdog
hare   		harebrained harelip harebell
hat   		hatrack hatpin hatband
hay   		hayloft haymaker hayseed
head   		headband headstrong headmaster
heart 		heartburn heartwarming heartworm
heavy   	heavyweight heavy-handed heavy-bearded
hell   		hellcat hellbent hellhound
hemi		hemisphere hemianopsia hemidemisemiquaver
		* hemicycle hemistich hemiparasite
hemo		hemophobia hemotoxin hemoglobin
		* hemostatic hemostasis
hen   		henhouse henpecked henbane
here   		herein hereafter heretofore
hexa		hexabasic hexadecimal hexavalent
		* hexachord hexapod
hide   		hideout hideaway hide-and-seek
high   		highlight highbrow highborn
hill   		hillside hilltop hillbilly
hind   		hindsight hindbrain hindgut
hip   		hipbone hiphuggers hipshot
hog 		hogtie hognut hog-backed
home   		homemade homeland homebody
homo		homosexual homocentric homocinchonine
		* homochromatic homograph homophone homoplastic
hook   		hookup hookworm hooknose
horo		horoscope horography 
		* horologic
horse   	horselaugh horsepower horse-and-buggy
hot   		hotbed hotshot hotbox
hour   		hourglass hour-hand hour-bell
house   	housebroken housefly housebreaker
hydro		hydrotherapy hydroelectric hydroappendix hydrocarbon 
		hydrochloric
		* hydrofoil hydrometeor hydrophone hydroplane hydroscope
		  hydrosphere hydrosulfate
hyper		hyperactive hyperchloric (acid) hyperplasmia
		* hyperextension hypermeter hypertension
hypno		hypnotherapy hypnogenetic hypnonarcoanalysis
hypo		hypoactivity hypochlorite hypocondylar
		* hypocenter hyposensitivity hypothalamus
ice   		icebox icebreaker iceberg
icono		iconoclast iconography iconostasis
		* iconoscope
il   		illegal	illegible illiterate illuminate
ill   		ill-suited ill-advised ill-natured
im   		imbalance impartial immeasurable imposition imbed
in 		indirect income inappropriate infection inmate inbreeding
inch   		inchmeal inchworm inch-pound
ink   		inkwell inkblot inkberry
inter   	interchange intercostal interkinesis
intra		intracavitary intragalvanization intraneural
intro   	introflexion introgastric
iono		ionosphere ionocolorimeter ionophoresis
ir   		irrational irradiate irreverent irreconcilable
iron   		ironfisted ironclad ironmaster
iso		isobody isocomplement isogenesis
		* isoantibody isobar isogram isolate
ivory   	ivorytype ivory-towerism ivory-billed (woodpecker)
jack   		jackknife jackstraw jack-in-the-box
jail 		jailbird jailhouse jailbait
jaw   		jawbone jawbreaker jawfish
jet   		jetliner jet-black jetport jet-propelled
juris		jurisconsult jurisdiction jurisprudence
key   		keyhole keynote keyboard
kick   		kickoff kickback kickstand
kilo		kilogram kilovolt kilocalorie
king   		kingpin king-cup
knock   	knockout knockabout knock-knee
knot   		knothead knothole knotgrass
knuckle   	knucklehead knucklebone knuckle-duster
lace   		lacework lacewing
lady 		ladybug lady-killer lady-in-waiting
lamp   		lamplight lamppost lampshade
land   		landfall landmark landlady
law   		lawman law-abiding
lay   		layoff lay-up lay-by
leather   	leatherneck leatherjacket leatherwork
lee   		leeway leeboard lee-gage
leg   		legman leg-break
letter   	letterhead letterpress letterperfect
life 		lifeboat lifeblood lifesaver
light   	lightface lightstruck lighthouse lightweight light-year
line   		linebacker lineman line-up
liver   	liverleaf liverberry liver-rot
lock   		lockjaw locksmith lockup
log   		logroll logjam logwood
long   		longbow long-winded long-suffering
look   		lookdown lookout look-in
love   		lovebird lovesick lovelock
lung   		lungfish lungworm lungwort
macro		macrobiotic macromania macrophagocyte
		* macrochemistry macroevolution macrograph
mad 		madcap  madhouse mad-dog
mail   		mailbox mailman mailbag 
main		mainmast mainstay mainstream
make		makeshift make-believe make-up
mal   		maladjusted malfunction malapropos
man   		manhunt manhelper man-eating
manu		manufacture manumotor manuscript manustupration
		* manufactory
master   	masterpiece mastermind master-at-arms
match   	matchmaker matchboard matchbox matchmark
matri		matriarch matrilocal matrilineal
may   		mayfly mayflower maypole 
meat   		meatball meathead meatman
medi   		medifrontal medipeduncle meditemporal
mega		megabuck megacecum megacephalic
		* megacycle megahertz megaphone megathere megaton
megalo		megalomaniac megaloclitoris megalocornea
		* megalocardia
melo		melodrama melomania melocoton meloplasty melocactus
meno		menolipsis menometrorrhagia menopause
mer		mermaid merman merpeople
		* merchant
mercuro		mercurochrome mercurophen mercurophylline
meta 		metasilicate metalinguistic
methyl   	methylamine methylguanidine
metro		metrograph metromania metronome metropolis metrofibroma 
		metrocyte
micro		microbacterium microdot microliter
		* microfilm micrometeorite microphone microorganism 
mid		midair midbrain midwinter
		* midcourse midship midmost midland midwife midterm
middle   	middleweight middle-aged middle-of-the-road
milk   		milkman milkweed milksop
mille		millepore millepede millefiori
milli		milliampere millibar millinormal
		* millimeter
mine   		minefield minelayer minesweeper
mini   		miniskirt minicourse minibus
mis   		miscarry mischief misdeed mislead misadventure
mito		mitochondria mitogenetic mitokinesis
mon		monarch
		* monatomic moneyed mongoose monkey monsoon
money 		moneybags moneychanger moneywort
mono		monoinfection monobasic monogametic
		* monochord monochrome monocycle monograph monotone
moon   		moonbeam mooncalf moonflower
mouse   	mousehole mousetrap mousefish
mouth   	mouthwash mouthpiece mouthbreeder
muck   		muckworm muckrake muck-heap
mud   		mudhole mudslinging mudcap
multi		multilateral multiphase multishot
		* multiaddress multicolored multilateral multinational
nano		nanocormia nanocurie nanosecond
		* nanometer 
neck   		necktie necklace neckline
needle   	needlework needlepoint needlefish
neo		neonatal neoarsphenamine
		* neocolonialism neoimpressionism
neutro		neutrosphere neutroclusion neutropenia
never   	nevermind nevermore never-never
new 		newborn newcomer newfangled
news   		newspaper newsreel newsprint
nine   		ninepins ninepence ninebark
nitro		nitroglycerin nitroprotein nitrobenzene
		* nitrostarch nitrochloroform nitrobacteria
no   		nobody no-hitter no-account
non             nonstop non-English nonnaval nonproductive noninterference
noon   		noontime noonday noontide
nor		normoadrenelin noratropine norleucine
		* noradrenalin
north   	northbound northeast
note   		notebook notecase noteworthy
noto		notochord notogenesis notomyelitis
nut   		nutcracker nutmeg nutgall
oc		occult occidental
octo		octopod octolateral octogynous
		* octosyllable
odd   		oddball oddside odd-pinnate
off   		offbeat off-color off-shoot
omni		omnipresent omnigraph omnidirectional
		* omnibus omnipotent
on 		ongoing onlooker oncoming
op		oppose oppress oppilate
		* opposition
ortho		orthography orthopedics orthosilic (acid)
		* orthochromatic orthocenter orthopsychiatry
oscillo		oscillogram oscilloscope oscillometer
		* oscillograph
other   	otherwise otherworldly other-directed
over   		overlook overhang overriding
oxy		oxypurine oxyhemaglobin oxyblepsia oxyphonia
		* oxymoron
pack   		packhorse packplane packthread
paddle   	paddleboard paddlewood paddlefish
pan   		panfish panhandle pancake
paper   	paperback paperhanger paperwork
par		paramour parboil parget
		* parrot partake
paleo		paleopsychology paleobotany paleocerebellum
		* paleozoology
palin		palindrome palingraphia palinphrasia
		* palingenesis
para   		paratrooper parachute parapet
pari   		parisyllabic paridigitate paripinnate
		* parilocal
pass 	 	passkey password passport 
passion   	passionflower passionfruit
patch   	patchwork patchstand patchhead
patri		patriarch patrilineal
pay   		payload payoff paymaster
pea   		peanut peashooter peamouth
peace   	peacemaker peacetime peace-pipe
pearl   	pearlfish pearlash pearleye
peep   		peepshow peephole
peg 		pegboard pegbox peg-legged
pen   		penname penknife penman penultimate peninvariant
penta		pentamethylene pentatonic
		* pentameter pentastich
penny   	pennyworth pennyweight
pepper   	peppermint pepperbox peppercorn
pepto		peptogaster peptogenic peptocrinin peptotoxin 
per		perchlorate permeate persulfate
		* peradventure percentile perform perfume perfuse permute 
		  peroxide person peruse perverse perforce
peri		peribulbar pericarp periencephalitis
petro		petrochemical petrosphere petroglyph
		* petrodollar
pheno		phenocryst phenotype phenobarbital
philo		philodendron philopatridomania 
		* philoprogenitive
phono   	phonograph phonoreceptor phonophobia
photo		photoelectron photomontage photosynthesis
		* photocopy photojournalism
phylo		phylobiology phylogenesis
pick   		pickaxe picklock pickpocket
pico		picofarad picometer picosecond
		* picotee picoline
piece   	piecework piecemeal piece-dyed
piezo		piezoelectricity piezometer piezotherapy
pig   		pigskin pigheaded pigboat
pigeon   	pigeonhole pigeonwing pigeon-toed
pilo		pilobezoar piloerection
pilot 		pilotfish pilothouse pilotweed
pin   		pinball pinpoint pincushion
pinch   	pinchpenny pinchbottle pinchcock
pipe   		pipestone pipefish pipe-clay
pit   		pitfall pitman pitsaw
place   	placeman place-kick place-name
plain   	plainclothes plainchant plainspoken
plano		planocellular planoconvex planography
		* planoconcave planometer
plate   	plateholder platelayer plate-dog
play   		playmate playboy play-act
plow 		plowboy plowshare plowland 
plug   		plughole plugugly plugboard
pneo		pneodynamics pneogaster pneograph
pocket   	pocketbook pocketknife pocket-handkerchief
poly		polyceptor polychromatic polyorchidism
		* polychrome polyclinic polygraph
poor   		poorhouse poor-spirited poor-mouth
pop   		popcorn popgun popeyed
pork   		porkchop porkfish porkpie (hat)
porno		pornography pornolagnia
poro		porocephalosis poroplastic
		* porous
post   		postwar postmaster postcard posthaste postcerebellar
postero		posteroanterior posterolateral posteroparietal
pot   		potluck potboiler potbelly
power   	powerhouse powerboat power-drive
pre   		prewar preconscious precirrhosis
press 		pressmark pressroom pressman 
pro		proatlas procephalic proptosis pro-war
		* probate proclaim proconsul procreative procure profile
		  profound profuse program prolong propose prorate protest
proto		prototype protovertebra
psycho		psychobabble psychoreaction psychotherapy
		* psychological psychoneurosis psychosurgery
pull   		pullover pullback pull-in 
pump   		pumpwell pump-action pumpman
punch   	punchboard punchball punch-drunk
push   		pushcart pushpin push-button
put   		put-on put-upon put-down 
quadri		quadrilateral quadriplegia quadriceps
		* quadripartite quadrivalent
quanti		quantimeter quantivalence
quarter   	quarterback quarterdeck 
quasi		quasifaithful quasifatal quasiheroic
quick   	quicksand quickset quick-freeze
quint		quintessence quintroon
race   		racecourse racetrack racehorse
radio		radiocarpal radiolocation radioscope
		* radiophone radiosensitive radiotelephone radiobroadcast
		  radioactive
rag 		ragbag ragweed ragman
rail   		railway railhead rail-splitter
rain   		raincoat rainbow rainwash
rat   		ratfish rattrap ratfink
raw   		rawhide rawboned raw-pack (method)
razor   	razorfish razorback razor-billed
re   		reword react
ready   	ready-made ready-mix ready-to-wear
retro		retrobuccal retrograde retropharyngitis
		* retroactive retroaction retrorocket retroversion
rib   		ribband ribgrass ribwort
		* ribosome
ribo		riboflavin ribonuclease ribodesose
right   	right-angled right-handed right-minded
ring 		ringleader ringbolt ringworm
rip   		ripsaw ripsnorter rip-roaring
river   	riverbed riverhead riverweed
road   		roadbed roadblock roadrunner
rock   		rockweed rockfish rock-bound
rool   		rollaway roll-back roll-top (desk)
root   		rootworm rootstock rootstalk
rope   		ropeway ropedancer ropewalk
rough   	roughcast roughdry rough-and-tumble
round 		roundhouse round-about 
rudder   	rudderpost rudderhead rudderfish
run   		runway runaround run-in
sacro		sacrococcyx sacrodynia sacroiliac
saddle   	saddlebag saddleback saddlecloth
safe   		safelight safekeeping safe-conduct
sail   		sailboat sailfish sailcloth
sales   	salesroom salesclerk salesmanship
salt   		saltbox saltbush saltceller
sand   		sandbox sandhog sandbag
sap 		sapsucker sapwood saphead
sauce   	saucepan sauceboat saucebox
saw   		sawdust sawfish sawbones
scape   	scapegoat scapegrace scape-gallows
scare   	scarecrow scarehead scaremonger
scatter   	scattergood scatterbrained scattershot
school   	schoolwork schoolteacher school-book
sclero 		scleroconjunctivitis scleroderma scleroprotein
		* sclerometer
screw   	screwdriver screwball screwworm
se		seduce
		* seat secession sedate semen sewage
sea 		seashore seaplane seadog
second   	secondstory secondhand second-class
seismo		seismograph seismology seismometer
		* seismoscope seismogram
self		self-respect self-hypnosis self-abuse
semi 		semicomatose semilunar  
set   		setback setup setscrew
seven   	seven-year sevenbark seven-up
shadow   	shadowbox shadowland shadowgraph
shake   	shakedown shake-up shakefork
sharp   	sharpshooter sharp-tongued sharp-fanged
sheep 		sheepdog sheep-dip sheepberry
shell   	shellfish shellfire shellback
shin   		shindig shinbone shinleaf
ship   		shipmate shipload ship-to-shore
shirt   	shirttail shirtband shirtwaist
shoe   		shoelace shoestring shoehorn
shop   		shoplifter shopkeeper shoptalk
short   	shortcut shortchange short-lived
shot   		shotgun shot-putter shot-peen
shovel 		shovelboard shovelnose shovelhead
show   		showdown showboat show-stopper
shut   		shutoff shutout shut-eye
sick   		sickbed sickbay sickroom
side   		sidearm sidecar sidelight
sight   	sightseeing sighthole sight-read
sign   		signpost sign-off signboard
silk   		silkworm silkscreen silk-stocking
silver   	silversmith silverleaf silverside
single 		singlestick single-handed single-breasted
sit   		sitfast sit-up sit-down
skin   		skinflint skin-deep skin-dive
slap   		slapjack slap-shot slapdash
sleep   	sleepwalking sleep-in sleepwear
slip   		slipstitch slipknot slip-up
slow   		slowdown slowpoke slow-witted
small   	smallpox small-time small-minded
smoke   	smokehouse smokestack smokejack
snake 		snakebite snakeroot snakefish
snap   		snapshot snapdragon snap-on 
snow   		snowball snowshed snowbell
so   		soever so-called so-and-so
soap   		soapbox soapstone soapsuds
soft   		softball softboiled softhearted
solid   	solid-state solid-looking solid-ungulate
some   		somebody somehow something 
soup   		soupbone soupspoon
sour   		sourball sourpuss sourdough
south 		southpaw southpaw southbound
space   	spacecraft spaceship spaceman space-time
spark   	sparkplug sparkoven spark-killer
spear   	spearmint spearfish spearhead
spectro		spectroscope spectrophobia spectrocolorimeter
		* spectrograph spectrometer
speed   	speedway speedboat speedball
spermato	spermatoblast spermatogenesis spermatoschesis
spin   		spin-dry spinproof spin-off
spino		spinobulbar spinocellular spinoneural
spit   		spitfire spitball spit-and-polish
sports   	sportscast sportswear sportsman
spring 		springtime springboard springlock
square   	squareface squaredance square-rigged
stage   	stagehand stagecoach stagestruck
stair   	staircase stairwell stairhead
stand   	standby stand-up standpipe
star   		stargazer starfish starflower
steam   	steamboat steamroller steamfitter
steel   	steelyard steelworker steelhead
steno		stenobregmate stenography stenophotic
step 		stepsister stepladder stepchild step-up stepfather
stereo   	stereotype stereoblastula stereofluoroscopy
stetho		stethograph stethomenia stethoscope
stick   	stickball stickpin stick-in-the-mud
stink   	stinkpot stinkbug stinkweed
stock   	stockyard stockbroker stock-still
stone   	stonechat stonecutter stone-deaf
stop   		stoplight stopgap stopcock
store   	storefront storehouse store-bought
story 		storybook storyteller storyboard
straight   	straightway straightforward straight-arm
straw   	strawboard strawberry straw hat
street   	streetcar streetlight streetwalker
strike   	strikeout strikebreaker strikebound
string   	stringholder stringhalt stringboard
strong   	strongbox strong-arm strong-willed
sub   		subabdominal subclinical subglossitis
sugar 		sugarhouse sugarplum sugar-coated
sun   		sunburn sunflower sundowner 
sup		suppose 
		* support supply suppositive
super   	superman superalkalinity superalbal
supra		supramolecular suprahepatic suprabuccal
sur   		surbase surrealism surreptitious surexcitation
sweat   	sweatband sweatbox sweatshop
sweep   	sweepback sweep-stakes sweep-second
sweet   	sweetbread sweetbriar sweetmeat
switch   	switchboard switchblade switchyard
sword   	swordtail swordfish swordplay
sym		symbiotic symmetrical symphonic
syn		syndactylia syndrome synreflexia
		* synecology synoptic syntax synthesis
table 		tablecloth tablespoon table-hop
tail   		tailgate taillight tailback
take   		takedown takeoff take-home (pay)
tax   		taxpayer tax-deductible
taxi   		taxicab taxiway taxiplane taxicorn
tea   		teakettle teahouse teaberry
tear   		teardrop tear-stained tear-jerker
tele   		television telescope telecast teleplay telekinesis
ten   		tenpin ten-gallon (hat) ten-penny (nail)
tera		teracycle terahertz teraohm
tetra   	tetrabasic tetravaccine tetradactylous
there 		thereabout thereabout therein 
thermo		thermobiotic thermolabile thermomassage
		* thermometer thermocouple thermodynamics
thick   	thickset thick-skinned thickhead
third   	thirdhand third-rate third-degree
thorough   	thoroughfare thoroughbred thoroughgoing
through   	throughout throughway through-composed
thumb   	thumbnail thumbtack thumbnut
thunder   	thunderbird thundercloud thunderclap
tibio		tibiofibular tibioscapular tibiocalcanean
tide   		tidemark tidewater tidehead
tie 		tieclasp tie-up tie-and-dye
tight   	tightrope tightwad tight-fisted
time   		timeserver time-consuming time-lag
tin   		tinfoil tinhorn tinsmith
tip   		tiptoe tiptop tipburn
toad   		toadstool toadeater toadflax
toll   		tollgate tollkeeper tollhouse
tom   		tomboy tomcat tomfoolery
tool   		toolmaker toolshed toolbox
tooth   	toothache toothpick toothwort
top 		topflight top-heavy topgallant
touch   	touchstone touchback touch-and-go
tow   		towpath towline towboat
trade   	trademark trade-in trade-last
train   	trainsick trainbearer trainmaster
trans   	translucent transplutonian transaminase
trap   		trapball trap-door trapshooting
tree   		treetop treehopper treefish
tri   		triangle tricycle trioxide
true 		truelove true-blue trueborn
turbo   	turbofan turbojet turbo-electric
turn   		turnover turnabout turnpike
turtle   	turtleneck turtleback turtlehead
type   		typewriter typecast typeface
twi		twilight twifoil twibill
		* twinight 
un   		undress unlock unnatural unfriendly unreasonable unsheathe
under   	underhanded underground underestimate
uni   		uniform unilateral unicycle
up   		upheaval upbringing upside-down
vine 		vineyard vineland vinedresser
vivi		vivisection vividialysis viviparous
waist   	waistcloth waistcoat waistband
walk   		walkout walk-in walkway
wall   		wallpaper wallboard wallflower
war   		warlord war-horse warhead
wash   		washout washroom washcloth
waste   	wastepile wastebasket wasteland
watch   	watchdog watchmaker watchtower
water   	watercool watercress watermelon
wave 		wavelength waveband waveguide
weather   	weatherman weatherboard weather-beaten
wet   		wetback wet-nurse wet-blanket
what   		whatnot whatever whatsoever
wheel   	wheelchair wheelbarrow wheelwright
when   		whenever whensoever when-issued
where   	whereby whereas whereabouts
whip   		whiplash whipcord whipsaw
whirl   	whirlwind whirlpool whirlabout
who 		whoever whodunit whoso
whole   	wholesale wholehearted whole-wheat
wide   		widespread wide-awake wide-eyed
wild   		wildcat wildflower wild-goose (chase)
wind   		windfall windburn windbag
window   	windowpane window-dressing window-shop
with   		without withhold withdraw
wood   		woodpecker woodpile woodblock
wool   		woolskin woolgrower woolgathering
word 		wordplay word-blind word-of-mouth
work   		workbook workday workhorse
world   	worldwide world-shaking world-weary
worm   		wormhole worm-eaten wormwood
wrist   	wristlock wristband wristdrop
yard   		yardstick yardarm
year   		yearbook year-end yearling
yellow 		yellowjacket yellow-bellied yellowweed

Rule For Hyphens:
      Even though hyphens ('-') do not currently get past the parser in a work-
      able way for the englex package:      
      Hyphens are used to join the parts of a compound words. In general the
      hyphen is used in recently made compounds and compounds still in the 
      process of becoming one word. Because usage varies considerably, no 
      arbitrary rules can be laid down. When in doubt consult the latest 
      edition of an unabridged dictionary.
      Rules:
      1)Words such as a single adjective before a noun are usually hyphenated,
      2)When compound adjective follow the noun, they usually do not require
  	the hyphen,
      3)When an adverb ending in ly is used with an adjective or a participle
	the compound is not usually hyphenated.
      Prefixes:
      When a prefix still retains it's original strength in the compound, a
      hyphen is used. In most instances, however, the prefix has been absorbed
      into the word and should not be separated by a hyphen.
	Contrast the following pairs of words:
	ex-president excommunicate     vice-president viceroy
	pre-Christian preconception    pro-British procreation
      [Reference Woolley, Scott, Bracher]

_______________________________________________________________________________














References:
           [Woolley, Scott, Bracher] page 358 College Handbook Of Composition
	   by E. Woolley F. Scott and F. Bracher

	   [AHD]: The American Heritage Dictionary Of The English Language
		  1976
